1111111111111111111111111111111111111
1.....E.....1.......................1
1..P......E.1..................1.1..1
1..1111111..1..1111111111..11111.1..1
1.E1.....1.....1.....1.....1........1
1..1.....1.....1.....1.....1........1
1..1..1..1..1111111..1..1111111111..1
1..1..1..1..1........1..............1
1..1..1..1..1........1..............1
1..1..1..1..1..1111111111111..1111..1
1.....1..1.....1........1........1..1
1.....1..1.....1........1........1..1
1111111..1111111..1111..1..1111.....1
1..1.....1........1.....1...........1
1..1.....1........1.....1........1..1
1..1..1111..1111111..1111111..1111..1
1.....1.....1..1.....1..............1
1.....1.....1..1.....1..............1
1..1111111..1..1..1111..1111........1
1........1..1..1........1..1........1
1........1..1..1........1..1........1
1111111..1..1..1111111111..11111....1
1..1.....1..1..............1...11...1
1..1.....1..1..............1....1...1
1..1..1111..1..1111111..1..1....1...1
1..1........1.....1..1..1..1..111...1
1..1........1.....1..1..1..1........1
1..1111111111111..1..1..1111........1
1....................1..............1
1....................1..............1
1111111111111111111111111111111111111